P  ##      ## #
##    ### ## ##
## ## ##     ##
##    ###### ##
#####      ##  
########   X   
###############